-T------------- 
--------------T 
--T-----------T 
--T-----------T 
--T--------TTTT 
--T------------ 
T-------------- 
T-------------- 
T-------------- 
T-------------- 
--T-----------T 
--T---T-------T 
--T---T-------T 
P-T---T--E---AT 
TTTTTTTTTTTTTTT 