TTTTTTTTTTTTTTT 
--------------T 
--------------T 
--------------T 
--------------T 
--------------T 
--------------T 
--------------T 
--------------T 
--------------T 
--------------T 
------T-------T 
------T-------T 
---P--T--A----T 
TTTTTTTTTTTTTTT 